***************
*A *      *   *
* *  * **   * *
* **  ** * *  *
*    *   **  **
*** *  *   *  *
*    * ***  *B*
* ** **   *  **
* **  * *  *  *
*   **   *   **
* *    *  *** *
* *** * * *   *
*    *  *   * *
* **   *  **  *
***************